pbzpagovpdasnimstpukkmxivbardr: upper-lower-lower-middle-middle-upper-upper-middle-middle-lower class
jzkvlpchogkyxshcjjqjqezbscijhm: lower-upper-upper-middle-lower-lower-middle-middle-lower-middle class
uvzarxgydverbdgvgttzxiezkijlrv: upper-upper-middle-lower-upper-middle-upper-lower-lower-middle class
fznrpswiounmjopdyavhepygzsknbz: upper-middle-lower-upper-middle-middle-middle-upper-lower-lower class
iyfbgeviifxzgecsdasnbnjpvwyvzd: upper-upper-upper-upper-middle-upper-upper-upper-middle-lower class
uocjxxjghaywlbeworhqhuqbsrppuf: upper-lower-lower-middle-middle-lower-middle-lower-middle-lower class
nbsfzdougkgidnltoeclaknyjkbjgs: middle-middle-middle-middle-lower-lower-middle-upper-middle-lower class
vldiyfrkmjochdpvhvpwgbuzndqdpt: lower-upper-lower-middle-lower-lower-upper-middle-lower-upper class
ukbuurvuoheqqxygpjobtlesbwcujr: middle-middle-lower-middle-middle-middle-middle-middle-lower-lower class
trylvqzyzbtogclnzsjzowxilemipp: lower-lower-upper-middle-lower-middle-lower-upper-upper-upper class
tomvrvpnqfrfqkcteehbucvnkxuhpk: upper-upper-lower-middle-middle-middle-lower-upper-upper-lower class
ablynwwhnoqmwptzgfhbbhysblisqs: lower-upper-lower-lower-middle-middle-upper-lower-upper-lower class
otpsacfyyiotuvmulfijjbhoizlrmv: middle-upper-middle-lower-upper-middle-upper-upper-upper-lower class
xmmzdxllgljwvwseyqlgbefwfhehmu: middle-upper-middle-lower-lower-lower-lower-upper-upper-lower class
jufvfjszotwkkxusesilzvshltojdy: upper-upper-upper-middle-middle-middle-lower-upper-middle-upper class
rsckcjerhvkryzwzawqbelmcinuxjb: middle-middle-lower-lower-upper-lower-middle-upper-lower-lower class
wmvjbpxhboqnrwbwatugvnvyihpslq: upper-upper-middle-middle-lower-lower-lower-upper-middle-upper class
hvnbmkyoasvegovohbnmwokruoeibb: upper-middle-middle-upper-upper-lower-upper-upper-lower-middle class
bvoaoiavravlwhbbitlgkpfumcpabw: lower-middle-middle-lower-upper-upper-middle-lower-middle-middle class
dwuifoewahwbggooyjiwfqsewvqahp: upper-middle-lower-lower-upper-upper-upper-lower-middle-upper class
rtrepesdscxmknekmjujajwblcvmpr: upper-upper-lower-lower-upper-lower-lower-middle-middle-middle class
mkejolljviehjrxrblgexqjraaokbj: upper-upper-lower-lower-lower-middle-lower-lower-lower-upper class
qgsgtzykeurwyogehorwyamfcjvfjn: lower-lower-lower-lower-upper-middle-middle-middle-middle-lower class
bpwbuxsrmlyptfvypszcmbpwwjahys: middle-lower-middle-lower-upper-middle-lower-middle-upper-middle class
qhfgcvepggbynwjjijfjbdmrmsomsf: upper-lower-middle-lower-lower-lower-middle-lower-upper-upper class
oqzckbfyttgmwwinxqtrbjdlatgemh: lower-lower-lower-lower-middle-lower-middle-lower-upper-lower class
csnsjtesmczbvuccdwpnxcrrziqqdk: lower-upper-middle-middle-upper-lower-lower-upper-lower-middle class
lyjlctdnbwkbbclvusbugqtiqeesqs: lower-lower-middle-middle-middle-lower-lower-lower-upper-middle class
hpmyjeqiexqrpglgjqzzahgjqzjbzv: middle-upper-middle-upper-middle-lower-lower-middle-lower-upper class
gaygfrwxexszwoswitzcwzolczshpn: middle-middle-lower-upper-middle-upper-middle-middle-middle-lower class
mpvejyvadsndxoatifmmhvaacptpum: upper-middle-middle-middle-middle-upper-upper-middle-upper-upper class
oqwadckwdkhwtwczehafccmduzyhup: lower-lower-upper-lower-upper-lower-upper-upper-middle-upper class
dttcrqepowkakpwuapexigejifdtri: lower-upper-upper-upper-lower-lower-middle-middle-middle-middle class
eenielbsjjamwjlsrbejbbsixqedhe: middle-lower-upper-lower-lower-middle-middle-upper-lower-upper class
tlxutgtqbgbvvjjkksktdimwmdrhoy: middle-upper-upper-middle-middle-middle-lower-upper-middle-upper class
jsynwbdnjjfzghfsilfrbywuonpimz: middle-lower-upper-middle-middle-upper-middle-middle-lower-middle class
czuycgmekialvelnigqfowawyepioz: middle-lower-middle-lower-middle-lower-lower-middle-middle-upper class
zukixkxuclkeptqujxnmwhmlvvfbfy: upper-upper-upper-upper-middle-upper-lower-upper-lower-lower class
bfrakhedzbttudmbetocjnnbgvjtmi: lower-upper-middle-lower-upper-lower-upper-middle-lower-lower class
fribrpiasyimakygfrvftpoosxzthy: upper-upper-lower-lower-middle-upper-lower-upper-lower-upper class
fynrkxhhqdrpsoqhpdgcejlbstiokb: lower-upper-middle-upper-upper-lower-upper-lower-middle-upper class
nzhccjibfyasnmdjugjgilstmzwafu: lower-middle-upper-middle-upper-lower-upper-lower-middle-lower class
nulprfuaxkkbtroniduonuhsecwawf: upper-lower-middle-middle-middle-lower-lower-middle-lower-lower class
uklcezkoahotzyxnictjyfwpzistyv: middle-middle-lower-lower-middle-middle-upper-upper-middle-lower class
zujqossxnfunsyprmorwlxjzpimxzt: lower-lower-middle-lower-lower-lower-upper-middle-lower-lower class
pvysamikrkpbsypealjnvibugnlovc: upper-upper-lower-upper-middle-lower-middle-lower-upper-middle class
docahfvrporiytouvocganhjskbusa: middle-lower-lower-lower-middle-lower-middle-lower-lower-lower class
rinkjzpyuntveouyifurxhntntwila: upper-middle-lower-lower-middle-middle-middle-upper-upper-upper class
rbfjrayjzyykrelelqcphouifnrzqm: upper-lower-upper-upper-middle-lower-lower-middle-upper-middle class
fzrtprtdkfoszapggrnppwtvisqtxk: upper-upper-lower-upper-middle-upper-lower-middle-middle-middle class
dthevcgerxxowrdofawyeccxflsoba: lower-middle-middle-upper-upper-middle-upper-lower-lower-lower class
ppfgdfumjjjaajuirpkjkuxslygxfh: upper-lower-middle-upper-lower-middle-upper-lower-lower-middle class
zzoqwqgqgvenvfacujfyaipluloyun: upper-upper-middle-middle-upper-middle-upper-upper-middle-upper class
rgqlqcewxkatinjwvzevwxkomawxpq: lower-middle-upper-lower-middle-middle-lower-upper-upper-upper class
mqwivhxprgzqtskfvpxovvmnfildci: lower-middle-upper-upper-upper-upper-middle-middle-upper-lower class
hlssakycftvqmveytjwqglvjylresf: middle-lower-lower-lower-lower-upper-upper-lower-upper-upper class
tnebegywjjsamphrddpqrulfnrumzp: upper-upper-upper-upper-upper-middle-middle-lower-middle-upper class
wdxhauryekctaqbbkopiahxehhorli: lower-lower-upper-lower-middle-upper-upper-middle-middle-lower class
ptbewonhsgsjmveqwnrgtqapgvowvo: middle-upper-middle-middle-lower-lower-upper-lower-middle-lower class
ewxiwnjyntpjpzbfnwflrdvjitjqix: upper-lower-lower-lower-middle-middle-upper-upper-lower-upper class
gdhcpylkexvrojtaggdrgpoolkaebi: upper-upper-middle-upper-middle-lower-middle-lower-middle-middle class
qynmdztmwgrmwqucnusylvqckzkmem: upper-middle-upper-upper-lower-upper-middle-upper-upper-lower class
rumibxzszgwdyiszicbfxvkmuwtwgo: upper-middle-middle-lower-upper-middle-upper-middle-upper-middle class
nyvxjmjnrgmnpgwuycgxsxjxaxrutj: middle-lower-middle-lower-upper-lower-upper-upper-lower-middle class
eoxkddkrfgvwycqwadmhdnmrrchfkq: upper-upper-upper-upper-middle-lower-middle-lower-upper-middle class
oxvoegyuuxpboypusvmlirtwudtskm: middle-middle-lower-lower-lower-middle-lower-middle-upper-upper class
oampafjejxkgfiqzpgavuihekinjgs: upper-lower-upper-lower-lower-lower-upper-upper-lower-middle class
kwtcwhotgcmvjmubphocqxyokiyyqr: lower-middle-lower-middle-middle-lower-lower-upper-upper-upper class
aflglvjyyvktwtznfmuvfzjehvalcy: middle-lower-lower-upper-lower-middle-middle-lower-middle-upper class
bknvbziqtrgsvazewtninryqfaagpm: upper-middle-upper-upper-middle-middle-middle-lower-lower-upper class
ojfowrmxguvgfaankewssuvgfzasrj: upper-upper-middle-lower-upper-middle-upper-middle-lower-middle class
dddiqlrsodtknyrlingptjomnfjpyp: lower-middle-lower-upper-middle-upper-lower-lower-middle-middle class
hrlckeytiyzvptwgmorssffuczmoyx: upper-upper-upper-lower-middle-upper-middle-lower-lower-upper class
ljnzmqiywmsgcqwiboegcmuzlblakl: middle-upper-upper-lower-lower-upper-lower-upper-lower-upper class
frqpcwtnrqpbqdafsbihkweoveneks: upper-upper-upper-upper-upper-upper-middle-middle-lower-middle class
pgoyptgyohguowabskwlgkgpqardtm: middle-upper-lower-lower-upper-middle-upper-lower-lower-upper class
anrlykgiuvsoepnskcgjsntkvrjtol: middle-upper-lower-middle-lower-lower-lower-middle-upper-lower class
rncrapmwmffwriecqvygmzsqlwtagg: upper-upper-lower-upper-upper-upper-lower-lower-lower-middle class
afidljbwretsmvtjmzpkxsattxyhha: upper-lower-upper-middle-upper-middle-middle-middle-upper-upper class
yquuqmfcvynbpmztvtuleboyfuerrh: middle-upper-upper-lower-middle-middle-middle-upper-upper-middle class
xoayspmqnstdbylrmkcexnzwsyvpwi: lower-lower-middle-middle-lower-upper-upper-upper-middle-upper class
khouvbczytawbzkcipgjmjgdjtsbuv: middle-upper-middle-upper-lower-middle-lower-middle-middle-upper class
uiidpllvfzskzvzxkcyiqchmqyyjlv: middle-middle-middle-upper-upper-lower-lower-middle-middle-lower class
evmuzxiabjoyqjzegqbadlwqqgqfcy: middle-upper-middle-upper-lower-lower-middle-upper-upper-upper class
bmoxupwfcdmfvahbnbxtghqadximcq: middle-upper-upper-upper-upper-lower-middle-middle-upper-lower class
ugvuzmzwtgtssmfpedrjjeurquaqkq: upper-upper-upper-lower-lower-lower-upper-middle-middle-upper class
pzkxwxxpzisdgikysvcvwlndwfytxh: middle-middle-upper-middle-lower-lower-upper-upper-lower-middle class
wiydpbqovlpgzwzxddxbhyhhymnnqa: middle-middle-middle-middle-upper-upper-middle-lower-lower-lower class
gvnfrudahokodqiscdfwbtriocofrf: upper-lower-upper-middle-middle-lower-upper-lower-upper-upper class
wpnglrzhtyakymyemcfpskkwfqzsvz: upper-middle-upper-upper-upper-lower-lower-upper-upper-upper class
qmqmurgeboougpapplgcwpshjjjmqn: lower-middle-lower-middle-middle-middle-lower-upper-upper-middle class
dleefzokqrfwsxbhxcnapqtvwcrpye: lower-middle-lower-middle-lower-upper-middle-upper-middle-lower class
lqwvykaqvlyuqxvukvurfsovctxnwx: upper-middle-upper-lower-middle-upper-upper-middle-middle-middle class
gmnymvhfjmpflsqwrhivzzogyvtmvo: lower-lower-middle-upper-middle-upper-upper-upper-upper-lower class
jxxfssxihhuinkwthppiigbhavxbgf: lower-middle-middle-upper-lower-middle-middle-middle-middle-upper class
muneqfrbzureqkvxamdkglduxvrkni: middle-lower-middle-middle-middle-lower-lower-middle-upper-middle class
zulwyuvtivweapevgowsgqclqpotgo: middle-middle-upper-lower-lower-upper-lower-lower-upper-lower class
aklbszvptisstqikfloghkcmtulxin: upper-lower-lower-middle-middle-upper-middle-middle-middle-upper class
kwjbozvtggzmsofoskorlcqwjeweam: upper-lower-upper-lower-upper-lower-middle-upper-middle-middle class
nsvwirnadnpuzjersvuhceojfucepb: lower-lower-upper-middle-upper-middle-upper-middle-upper-upper class
