bzx: lower class
yggslq: lower-lower-upper-lower-lower-lower-upper-lower class
dwqwgr: middle-upper-middle-lower-lower-upper class
xf: upper-upper-upper-lower-upper-upper-lower-middle-upper-lower class
cexabfsplchttwirarcpi: middle-lower-upper class
zdqvqmyaykcrzcdpzgpupgdtyjdgbb: middle-lower-middle-middle-middle-upper-upper-upper class
xjipxpirnhsufwjctpxlk: middle-middle-upper-middle-upper-upper-upper class
mxreu: lower-lower-middle-middle-middle-upper-lower-upper-middle class
evcjhrkbjqnnuusbukmq: middle-lower-upper class
nwhrmsoxxhcqlny: lower-lower-lower-upper-lower-upper-lower-middle-middle class
vgdtvirclwymfd: upper-lower-upper-lower-lower-middle-lower-middle-upper-middle class
chjethgrmuankdmflmtkkltqndvkzo: lower-middle-upper-middle-upper-upper-middle-middle-lower class
oegcsqeqodeldwssk: middle-lower-lower-lower-middle-middle-middle-upper-lower-upper class
ocepaekxmjsko: upper-upper-upper-lower-upper-lower-lower class
k: lower class
wafbafibpcfndaxscyfpnuipnv: upper-middle-middle-middle class
skgmdgfyzfnmfljy: middle-upper-middle-lower-upper class
hjvptsqyraolupolqmrisaeoythnhs: lower-upper-middle class
qwbjotnfttj: upper class
xyyock: lower-middle-middle-upper-middle-lower class
yukmeyiglaflsarhtdnskbubhutwqd: middle-upper-upper-upper-middle-upper-lower-upper class
ngkkv: middle-middle-lower-upper-lower class
pqolubrchnjc: lower class
vlevmaimgj: upper-lower-upper-upper-upper class
ijbafzfejbrtpzrkbt: middle-middle-middle-middle-upper-lower-upper-middle class
jpgswbmcztmjybolf: lower-upper-middle-lower-lower-middle-lower class
qmscu: lower-upper-lower-middle class
bsmyafhhbwiyyqlfktqtgz: upper class
gohgadcfjczyhpocovjnq: upper class
hnzp: lower-upper-lower-lower-middle-middle class
roopwrqqyxxjna: middle-upper-upper-upper-middle class
uvjsslqbfu: middle-lower-lower-upper class
lsdligdolyhsdcyinmxgdpihlywta: upper-middle class
hzoqafnsfbtzxodiddvkp: upper class
nnczojbthadpmrlyhgkadryqwvgexw: lower-lower-lower class
cwyoynsfglqnwtawgpoxvtqp: lower-lower-middle-upper-upper-middle-lower-upper class
gfpiztjntsaxcfqeqcrgcapdpy: middle-middle-lower-middle-lower-upper-upper class
ooewxrbnbie: middle-upper class
ehuhllvhgzvnob: lower-upper-middle-middle class
