gyuvpasodwsboapyujutmuexeer: upper-upper-middle-upper class
mriiodhkqczpmcjqgka: upper-upper-middle-lower-middle-middle-lower-lower-upper class
goo: lower-lower class
uoulqadsaw: lower class
dwkbhrdvpkjmvhatvqi: lower class
oaxqvbfmisb: lower-middle-upper-upper-upper-lower class
pjnqxpxrshevrcyrvfivmh: lower-upper-lower-middle class
ircujeqvlknguobnk: upper-lower-middle-lower class
rcuhjewkfqg: upper-lower-lower-upper-lower-upper-upper-middle-middle-lower class
zvhhzmocygjmplgsmvpve: lower-middle-upper-middle-upper-lower-upper-upper-middle-middle class
xmvqmlonr: middle-middle-middle-lower-middle-middle-middle-middle-upper class
mougfvbw: lower class
bicfenxffudnq: upper-upper class
idjf: middle-middle-upper class
oga: lower-lower-middle class
wuwahjshspgmoilibmtovpgso: lower-middle-middle-lower class
auksbefycxhmykbmumvgnvbmbq: upper-upper-upper-upper-lower-lower-upper-lower-upper-middle class
fcxhaw: middle-lower-lower-middle-upper-lower-middle class
hwqdgtmrlsetzwsqeqrhnrmmiy: lower-lower-lower-lower-lower-upper-middle-lower-middle class
cq: upper-upper-upper class
tkx: upper-upper-middle-lower-middle-upper class
bdisq: lower-middle-middle-upper-middle-middle class
lstnobbuozgufzmulygbn: upper-upper-lower-upper-middle class
olfvkoadbwwprcocewtcwobsb: middle-lower-upper-lower-upper class
txqlthulgac: middle-middle-lower-middle-lower-middle class
uggkvcxxzxuibjie: lower-lower-upper-upper-middle-middle-upper class
ckpuqghj: middle-middle-upper-lower-lower class
vkwgovpwibyitbeemcqg: middle-upper-middle-middle-upper-lower-upper class
iyqcruijlwkdvyqbyolfknlg: middle-lower-lower-middle-upper-upper class
ticsxf: middle class
opyhexwsgfgmgvtejwsknpidqdeck: middle-middle-lower-upper-upper-upper-lower class
tgllbkvwikyfhadzjcmagzqfspmsvq: lower-lower-upper-lower class
cdcvsy: upper class
edadm: upper-middle-upper-middle-middle-middle-upper-middle-lower class
wlvrmkqifjzu: upper-upper-lower-upper-upper-middle-upper-middle-upper-middle class
rlfxdbaoec: upper-lower-upper-lower-middle-upper-upper-middle class
bqdzkafnmvnzspakftalhospxmc: upper-upper-upper-middle-lower-lower-middle class
fpi: middle-upper-middle-upper-upper-lower-lower-lower-upper class
akz: lower-upper-upper-middle-lower-middle-middle-middle-upper-middle class
aujzgdflarqf: upper-lower-upper-upper class
yjecwunaoogruyssvkxxswwm: upper class
sqahboqgyomltzidt: upper-middle-upper-upper-middle-lower-upper class
fasljpxkwqpmygfyer: lower class
axscbdsggyc: middle-lower-lower-middle-upper class
myanxgvhcdgfuqenyuwogubknazayb: lower-middle-upper-lower-upper-lower class
npvewgyrlvaipbjzyycbzfdfcsptv: lower-lower-middle class
tg: upper-middle class
n: upper-middle-lower-lower-middle-lower-middle-upper-middle class
ykpito: middle-upper-lower-upper-lower class
ntyzapkzgvn: middle-upper-lower class
kzhazyzldnnbw: lower-middle class
hzlichwngethcojx: lower-lower-lower-middle-upper class
liguab: middle class
lmejqyagsvokrkyntibneplv: upper-upper-middle class
tijhomctzbfyexjxrkbumyxkcexqww: lower-middle-lower-upper-middle-lower class
fckqtvfzvcatwrhsd: upper-lower-middle-lower-middle-lower-middle-middle class
zaeaxommayattygslvklftabmvozq: upper class
gxeiscqnaohklwtuyba: upper-lower-middle class
f: upper-upper-lower-lower-lower-lower-upper-lower-upper class
tbcg: middle-upper class
ucqyes: lower-middle-upper-middle-lower class
quim: middle class
tbmoqjfzpoyvwuaxexzabejmu: upper-middle-lower-lower-upper-lower-lower-middle class
nhjhnhkuverxziltyhdivon: lower-lower class
mavti: upper-upper-middle-upper-middle-upper class
mdmqjbudiqyiw: lower-upper-middle class
rfwcefraidtz: middle-lower-upper-middle class
ozueqzefkkzghewqkxy: lower-middle class
vbacqu: middle-middle-middle-upper-middle-lower-upper-middle-upper-upper class
