Mark: middle-lower-middle-lower-upper-middle-middle class
Christian: middle-upper-middle-lower-lower class
Heather: lower-middle-lower-lower-middle class
Jeremy: lower-middle-upper-upper-upper-middle-middle-middle-upper-middle class
Bryan: upper-lower-middle-lower-upper-upper-upper-upper-middle class
Ryan: upper-lower-middle-upper-middle-upper-upper-middle-middle class
Victoria: upper-lower-upper-middle-lower-upper-upper-lower class
Raymond: upper-lower-middle-middle-middle-lower-lower class
Johnny: upper-upper-middle class
Bruce: lower-lower-upper-lower-upper-lower-middle class
Debra: middle class
Cheryl: upper-lower class
Robert: upper-upper-middle-upper-upper-lower class
Linda: upper-lower-upper-lower-upper class
Brandon: middle-lower-middle-lower class
Andrea: upper-middle-upper class
Louis: middle-lower class
Jordan: lower-middle-middle-upper-lower-upper-lower-upper-middle-lower class
Lisa: upper-lower-lower-upper-middle-upper-lower-middle-middle-upper class
Kenneth: middle class
Olivia: middle-lower-upper-lower-middle-middle-lower class
Sean: middle-upper class
Diane: middle-upper-middle-middle class
Gregory: middle-upper-middle class
Madison: upper-upper-upper-middle-middle-middle-lower class
Michael: upper class
Nathan: lower-upper-upper class
Betty: middle-lower-middle-lower-upper-lower-middle-upper-lower class
Rebecca: middle-middle-middle class
William: middle-middle-lower-lower-upper-upper-upper-middle-lower-middle class
Hannah: lower-middle-upper-middle-middle-lower-middle class
Stephen: middle-upper-lower-middle-middle class
Jonathan: upper-middle-middle-middle-upper class
Barbara: lower-middle-middle-upper-lower-middle-upper class
Michelle: lower-middle-middle class
Deborah: lower-middle-upper-lower-middle-middle-upper-lower class
Abigail: upper-middle-middle-middle-upper-lower-middle class
Anna: lower-upper-middle-middle-middle class
Janice: upper-middle-upper-upper-upper-middle class
Nicholas: upper-lower-lower-middle-lower-middle class
Mary: middle-middle-upper-upper class
Bobby: lower-middle-lower-lower-middle class
Kimberly: lower-middle-middle-middle-lower-middle-lower-lower class
Alan: lower-lower-lower-upper-lower class
Andrew: upper-upper-middle-upper-middle-lower-upper-middle-lower-middle class
Douglas: middle-lower-upper-upper-lower-middle-upper class
Joseph: upper-middle-middle-lower-upper-middle-middle-middle-lower class
Lawrence: lower-lower-lower class
Ralph: upper-lower-upper class
Kathryn: middle-middle-lower-lower-middle class
Emma: lower-lower-middle-middle-middle-middle class
Helen: lower-upper-lower-upper-lower-middle class
Marie: upper-upper-lower class
Samantha: middle-lower-upper-upper-upper-middle-lower-lower-middle class
Sandra: upper-upper-lower-lower-upper-upper class
Paul: middle-middle-middle-lower-lower-upper-lower-upper-lower class
Kyle: lower-lower-middle-upper-lower-upper class
Billy: middle-middle-middle class
Sharon: upper-upper-lower-lower-upper-middle-lower-middle-upper-middle class
Harold: lower-lower-upper-upper-lower-middle-middle class
Kayla: lower class
Philip: middle-upper-upper-lower-middle class
Daniel: middle-middle-middle-lower-upper class
Jeffrey: upper-upper-middle-upper-middle-lower-upper class
Jessica: middle class
Stephanie: middle-lower-upper-lower-lower-lower-upper-lower-upper-lower class
Gloria: lower-middle-upper-lower-middle-lower-lower-middle-lower class
Bradley: lower-upper class
Sophia: middle-middle-middle-lower class
George: upper-lower-middle-upper-lower-upper-lower-middle-middle-middle class
Doris: upper-lower-upper-middle-upper-lower-lower class
Juan: lower-middle-lower-middle-middle-upper-upper-middle-upper class
Gary: upper-middle-upper-middle-lower-upper-upper-lower-middle class
Zachary: lower-middle-middle-upper class
Jacqueline: lower-upper-lower-upper class
Ann: middle-upper-upper-lower-middle-upper-lower-upper-lower-middle class
Teresa: upper-upper class
Frank: middle-upper class
Anthony: upper-lower-lower-upper-middle-upper-lower class
Julia: lower-upper class
Jose: lower-upper-lower-upper-lower-lower-lower class
Roger: middle-lower-lower-middle-lower-upper-upper-lower class
Dorothy: middle-lower-upper-upper-lower-upper-upper-lower-lower-upper class
Alexis: lower-middle-upper-lower-lower-lower-upper class
Cynthia: middle-lower-upper-upper-upper-middle-middle class
Judith: upper-upper-lower-upper-middle class
Terry: upper-middle-lower-middle-middle-upper-lower-middle-lower class
Joan: middle class
Wayne: lower-lower-lower-middle-lower-middle-middle-middle-lower-middle class
David: lower-middle-lower-upper class
Denise: middle-upper-middle-middle-lower-upper-lower class
Justin: middle-middle-upper class
Jacob: upper-lower-middle-middle-middle-middle-upper-lower-middle-middle class
Kelly: upper-lower-upper-upper class
Kathleen: upper-lower-upper-middle-upper class
Logan: lower-upper-lower-middle-upper class
Dennis: lower-middle-upper-upper-upper-middle-lower-lower-middle-middle class
James: lower class
Katherine: middle-upper-middle-middle-lower-lower-lower class
Peter: upper-upper-upper class
Ronald: middle class
Grace: lower-lower-lower-lower-lower class
Jean: middle-middle-upper-lower-upper class
Elizabeth: lower-upper-middle-lower-middle-middle-lower class
Tyler: middle-middle-middle-middle class
Theresa: middle-lower-upper-middle-upper-upper-middle class
Diana: middle-upper-lower class
Joyce: lower-upper-upper-middle-upper-upper-middle-middle-lower-lower class
Gabriel: middle-lower class
Willie: lower-upper class
Jack: middle-middle-lower class
Jennifer: upper-middle class
Amy: lower-upper-middle-lower-lower-upper class
Vincent: middle-lower class
Brittany: upper class
Larry: upper-lower-upper-upper-middle-lower-middle-upper-middle class
Rachel: lower-upper class
Frances: lower class
Timothy: lower-middle-lower-middle-upper class
Russell: lower-upper-upper-lower class
Virginia: middle-upper-lower class
Brenda: lower-middle class
Alice: lower-upper-upper class
Judy: upper-upper-lower-middle-upper-middle class
Gerald: middle class
Kevin: lower-lower-lower-lower-lower-middle-lower-lower-middle-middle class
Roy: upper-upper class
Albert: upper class
Christina: upper-middle-lower-middle-middle class
Shirley: middle-lower-lower-upper-middle-middle class
Carl: middle-lower-middle-middle-middle class
Noah: middle class
Carolyn: lower-middle-lower-middle-upper-lower class
Janet: upper-lower-upper-upper-lower-lower-lower-lower-middle-middle class
Samuel: middle-middle-middle-lower-middle-upper-upper-upper-lower-lower class
Evelyn: middle-middle class
Ashley: lower-lower-lower class
Arthur: middle-upper-middle-middle-lower class
Eric: upper-lower-upper-lower-upper-middle class
Beverly: upper-middle-upper-middle-upper-lower-lower-upper class
Danielle: middle-upper-upper-upper-middle-middle-middle-lower-middle class
Carol: middle-lower-upper-middle class
Edward: lower-lower-upper-upper-middle-lower-middle-lower-lower class
Julie: middle-middle-lower-upper-middle class
Scott: middle class
Dylan: middle class
Marilyn: upper-middle-upper-middle class
Nancy: middle-upper-upper-middle-middle-lower class
Jesse: upper-upper-lower-lower-middle-lower-lower-upper class
Patricia: upper-lower-middle-lower-middle-upper-lower class
Angela: upper-upper-middle-middle class
Brian: middle-middle-upper-middle-middle-upper-upper class
Donald: upper-middle-upper-upper-upper-upper-upper-middle-middle-middle class
Steven: lower-upper-upper-upper class
Eugene: middle-upper-middle-middle-lower-middle-upper-upper class
Amber: middle-middle-middle-upper-lower-middle-middle-middle-middle-lower class
Adam: upper-upper-upper-middle-middle-lower-middle-upper-middle-middle class
Keith: middle-upper-middle-upper-upper-lower-middle-lower-middle class
Benjamin: lower-lower-upper-lower-lower-upper-middle-upper-lower class
Lori: middle-middle-middle-middle-upper-upper class
Walter: lower-upper-middle-upper class
Christopher: lower-lower-middle class
Catherine: upper-lower-upper-middle-upper-upper-upper-upper class
Donna: lower-lower-lower-middle-middle-middle-upper-upper class
Jason: middle-lower-upper-lower-upper-upper-upper-middle-upper-upper class
Joshua: middle-middle-middle class
Laura: upper-lower-lower-upper-middle-middle class
Amanda: upper class
Karen: lower-lower-upper-middle-upper-upper-lower-middle class
Randy: lower-middle-upper-lower-lower-upper-upper-lower-middle-middle class
Ruth: lower-lower-middle-upper-upper-middle-lower-lower-middle class
Matthew: middle-middle-middle-middle-lower class
Henry: upper-lower class
Richard: middle-upper-lower class
John: lower-middle-upper-upper-middle-middle-middle-middle-middle class
Susan: middle-middle-middle-middle-middle-upper-upper-lower class
Melissa: lower-lower-middle-upper-lower-middle-middle-middle-upper class
Rose: upper-upper-lower class
Jerry: middle-lower-middle-lower-upper class
Christine: middle-middle class
Sarah: lower-lower-middle-lower-lower-lower-lower-lower-upper-upper class
Alexander: upper-middle-upper-lower class
Emily: middle-lower-lower-middle class
Sara: lower-middle-upper-middle-middle-upper-middle-middle-middle-upper class
Jane: upper-middle-upper-middle-upper-lower-lower-upper class
Ethan: lower-upper class
Lauren: middle-lower-middle-middle-middle-middle-lower-middle class
Martha: middle class
Patrick: middle-upper-lower-middle-middle-middle-upper class
Aaron: upper-upper-upper-middle-lower class
Nicole: upper-upper-lower-lower-lower-lower-upper-middle-lower-upper class
Austin: lower-middle class
Pamela: upper class
Natalie: middle-upper-lower-middle class
Thomas: middle-upper-middle-lower-lower-upper-middle-middle-middle-middle class
Charles: lower class
Megan: middle-middle-upper-upper-middle-lower-middle class
Joe: middle-upper-lower-lower-middle-middle-upper class
Maria: upper-lower class
Margaret: upper-lower-upper-upper-middle-upper-lower-lower class
